R 800 600

NO textures/wall_no.xpm
SO textures/wall_so.xpm
WE textures/wall_we.xpm
EA textures/wall_ea.xpm

S textures/sprite_1.xpm
F 184,113,27
C 51,198,227

1111
11
1111

1111111111 111111    1111111
100000020011000001111000001
10110000011100111000000000010001
10010000000011   10000010001
1011022201110011100001000011001
10000000001100000111011110001
11110111111111011100000010001
11111111111111011101010010001
11000000110101111100000010001
10000000000000001100000010001
11111          11111111111111

111111111111
100000000001
100100010001
100000000001
100000000001
100000000001
111111111111

1111
1N01
1111