R 800 600

NO textures/wall_no.xpm
SO textures/wall_so.xpm
WE textures/wall_we.xpm
EA textures/wall_ea.xpm

F 184,113,27
C 51,198,227

1111
11
1111

1111111111 111111    1111111
100000010011000001111000001
10110000011100111000000000010001
10010000000011   10000010001
1011000001100011100001000011001
10000000001100000001011110001
11110111111111N11100000010001
11111100000001011101010010001
11000011110101111100000010001
          1110001100000010001
11111          11111111111111




111111111111
100000000001
100100010001
100000000001
100000000001
100000000001
111111111111

1111
1001
1111
