NO textures/wall_no.xpm
SO textures/wall_so.xpm
WE textures/wall_we.xpm
EA textures/wall_ea.xpm

F 51,120,230
C 51,198,227

1111
11
1111

111111111111
100000000001
100100010001
100000000001
10000000N001
100000000001
111111111111

1111
1001
1111
